R 600 400

NO textures/brick.xpm
SO textures/stone.xpm
WE textures/wood.xpm
EA textures/metal.xpm
S textures/sprite.xpm

F 255,77,77
C 255,33,33

11111111111111111111111111111111
10000000000000000000000000000001
10000111111111111111111111111111111111111111111111111111111111111111
10E001
10000111111111111111111111111111
10000000000000000000000000000001
10000000000000000000000000000001
10000000000000000000000000000001
10000000000000000000000000000001
10000000000000000000000000000001
10000000000000000000000000000001
10000000000000000000000000000001
10000000000000000000000000000001
10000000000000000000000000000001
10000000000000000000000000000001
10000000000000000000000000000001
10000000000000000000000000000001
10000000000000000000000000000001
10000000000000000000000000000001
10000000000000000000000000000001
10000000000000000000000000000001
10000000000000000000000000000001
10000000000000000000000000000001
10000000000000000000000000000001
11111111111111111111111111111111
