R 1200 400

NO textures/brick.xpm
SO textures/stone.xpm
WE textures/wood.xpm
EA textures/metal.xpm
S textures/sprite.xpm

F 255,77,77
C 255,33,33

        1111111111111111111111111
    1   1100000111110000000011111
11110111 1110101 101111010001
11111111 1111111 1111111111111111
