R 1000 500
          
NO textures2/colorstone.xpm
SO textures2/bluestone.xpm
WE textures2/eagle.xpm
EA textures2/mossy.xpm
S textures2/pillar.xpm

C 63,115,206
F 138,71,4

11111111111111111111
10000000002000000001
10000000000000000001
1000000000N000000001
10001010000101000001
10001110000111000001
10001110000111000001
11111111111111111111
