R 500 500

NO textures32/brick.xpm
SO textures32/metal.xpm
WE textures32/stone.xpm
EA textures32/wood.xpm
S textures32/sprites/pillar.xpm

C 138,71,124
F 255,0,0

1111111111111111111111
1000000000020000000001
1000002000000000020001
10000000000002000000N1
1000010100001010000001
1000011100001110000001
1002011100001110000001
1111111111111111111111
