R 600 480

NO textures/brick.xpm
SO textures/stone.xpm
WE textures/wood.xpm
EA textures/metal.xpm
S textures/sprite.xpm

F 255,77,77
C 255,33,33

111111111111111111
100000000000000001
100000000000000001
100000000000000001
10000000W000000001
100000000000000001
100000000000000001
100000000000000001
111111111111111111
