R 500 500

NO textures32/brick.xpm
SO textures32/metal.xpm
WE textures32/stone.xpm
EA textures32/wood.xpm
S textures32/sprites/pillar.xpm

C 138,71,124
F 255,0,0

11111111111111111111111111111111111111111111111111111
10000002200000000000000000200000000000000000000000001
10000000000000000000020000000000002222000000020020001
100020002000200000000000000020000000000000000002000N1
10000000000000000000101000010102000000002020202000001
10000000000000000000111000011100002000000000000000001
10020000000002000000111000011100000000000000000000001
11111111111111111111111111111111111111111111111111111
