R 1200 400
NO textures/brick.xpm
SO textures/stone.xpm
WE textures/wood.xpm
EA textures/metal.xpm

S textures/sprite.xpm
F 255,77,77
C 255,33,33

1111111111111111
1000000000010001
1000000000000001
1000000000000001
10000N0000000001
1000000000000001
1000000000000001
1000000000000001
1000000000000001
1000000000000001
1000000000000001
1111111111111111
